#######################################
#                                     #
#                                     #
#                                     #
#                                     #
#                                     #
#                                     #
#                                     #
#                                     #
#                                     #
#           F            W            #
#          ###          ###           #
#        #######   P ########         #
#         ########  ########          #
#          #################          #
#            #############            #
#              ##########             #
#               ########              #
#                #####                #
#                  #                  #
#######################################
#######################################